NO ./txt/north.xpm
SO ./txt/south.xpm
WE ./txt/west.xpm
EA ./txt/east.xpm
F 60,60,60
C 135,206,235

111111
100001
10S001
100001
111111
