NO ./txt/north.xpm
SO ./txt/south.xpm
WE ./txt/west.xpm
EA ./txt/east.xpm
F 60,60,60
C 135,206,235

1111111111111
1000100000001
1010101010101
1000100000001
1011101110101
100N100000001
1111111111111
