NO ./txt/wall.xpm
SO ./txt/wall.xpm
WE ./txt/wall.xpm
EA ./txt/wall.xpm
F 50,50,50
C 100,100,255

11111111111
10000000001
11111011111
10000000001
10000N00001
10000000001
11111111111