NO ./txt/north.xpm
SO ./txt/south.xpm
WE ./txt/west.xpm
EA ./txt/east.xpm
F 200,150,100
C 50,100,150

111111111111
100001100001
100001100001
100000000001
100001N00001
111111111111