NO ./txt/north.xpm
SO ./txt/south.xpm
WE ./txt/west.xpm
EA ./txt/east.xpm

F 30,20,20
C 40,0,40

1111111
1000001
10N0001
1111111

