NO ./txt/north.xpm
SO ./txt/south.xpm
WE ./txt/west.xpm
EA ./txt/east.xpm
F 60,60,60
C 135,206,235

111110
100001
10N001
100001
111111
