NO ./txt/north.xpm
SO ./txt/south.xpm
WE ./txt/west.xpm
EA ./txt/east.xpm
F 60,60,60
C 135,206,235

N11111
111111
111111
