NO ./txt/north.xpm
SO ./txt/south.xpm
WE ./txt/est.xpm
EA ./txt/east.xpm
F 60,60,60
C 135,206,235000

1111111111
1000000001
1000000001
100000N001
1111111111
